NO ./path_to_the_north_texture
SO ./path_to_the_south_texture
WE ./path_to_the_west_texture
EA ./path_to_the_east_texture
F 220,100,0
C 225,30,0

                        111111111111 111111111111111
                        100000000011 110000000000001
                        101100000111 110000000000001
                        100100000001 100000000000001
                11111111101100000111 110000000000001
                10000000001100000111 110111111111111              
                11110111111111011101 10000010001
                11110111111111011101 11010010001
                11000000110101011101 10000000001                     
                10000000000000001101 10000010001
                10000000000000001101 11010010001
                11000001110101011111 11011110N0111
                11110111 1110101 101 11111010001
                11111111 1111111 111 11111111111
