NO ./assets/textures/eagle.xpm
SO ./assets/textures/redbrick.xpm
WE ./assets/textures/wood.xpm
EA ./assets/textures/purplestone.xpm
F 34,34,34
C 170,170,255

                                                 1111111111111
                                                 1000000000001
                                                 10000000000011111
                                                 10000000000000001
                                       11111     10000001111110001
                                      10000111111100011111111100011111
                                      10000110000000110000000000000001
                                      10000110000000110000000000000001
                                      100000000000000111111111111001111111111111111111111111111
                                      10000011000000010001      10000000010000000000000000000001
                                      10100111100000010001111111100000000000000000000000000000001
                                      101000110000000100000000000000000000000000000000000000000001
                                      100000000000000000000000000000001111111111111010000100000001
                                      100001000000010000011111111111111           1010001110000001
                                      11111111111111000001                        1010000100000001
                                      11111111111111000001                        1010000000000001
                                      111111111111110000011                       1011111111110001
                                      100000000000000000001                       101        10001
                                      1111000000000000000011                      101        10001
                                      10000000000000100000001                     101        10001
                                      100001111111111111111111                    1011111111110001
                                     100001                                       1000000000000001
                                    100001                                        1000100000000001
                                   100001                                         1010001000010001
                                  100001                                          1000000000000001
                                 100001                                           1110001111111011
                               11110001                                             10001     100111
                               100000001                                            10001     100001
                               1110000001                          1111             10001     111001
                                 10000111                          1001111111111111110001111111100001
                                 100001                            1000000000000000000000000000100001
                                 100001                            1111000000000000000000000000000001
                                 100001                               1000011111111111111100000100001
                   11111111111111100001                               100001             100001111111
                   10000000000000000001                               100001             100001
111111     1111111110000000000000000001                               100001             1000001
100001 11111000000000000111111111100001111111  11111111111111         1000011111111111111100001
100001 100000000000000001        10000100000011000000000000001111111111000011111000110001100001
100011100111000111011111        100000000000000000000000000000000000000000111111101100011000011111
100N011001  1000111010001        100000000000000000000000000000000000000000111111100000000000001001
1000000001  10001 1010001        1111111111111111111111100000111111111100001111100011000000000110011
1000011111  10001 1000001111111111                     1000001        100001111100011000000000010001
111001      10001 1100000000000001                     1000001     111100001111111000001100000010101
  1001111   10001   1001000000000111111                1000001     100000001111111000001100000000101
  1000001   100011111101111110000000001                1000011     100100001111111110000000000010001
  1111001   1000000000000000000000000011111111111111111100011111111100100000000000000000000000011111
     10011111000000000000000000000000000000000000000000000000100000100100000000000000000000000000001
     10000000000000000000000000000000000000000000000000000000000000000111111111111111111000000010001
     10000000000111111011111111111111111110111111111111000001000001001             1000000000010001
     100000000001    10001                101          100000100000100111111111111111001000000000001
     111111111111    100011111111111111111101          100000111111100000000000000000001000000000001
                     100000000000000000000001          100000111111000000000000000000001000000000001
                     1001111111111111111111011111111111100000111111100111111111111111111111111111111
                     1111                 10000000000000000000000000001
                                          11111111111111111111111111111
