NO ./assets/textures/eagle.xpm
SO ./assets/textures/redbrick.xpm
WE ./assets/textures/wood.xpm
EA ./assets/textures/purplestone.xpm     
F               34,34,34
C 170,170,255

111111111111111111111111111
100000000011110000000000001              
100000110111110000000000001
100000110001100000000000001
100000111100000100000000001
100000001100000100000111111
100100001111110111010000001              
100100001111110111011010001
110010001101010111011000001
100010000000000000011000001
100000000000N00011011010001
110000011101010111111011111              
111101111111110101111110101
111111111111111111111111111
