NO ./path_to_the_north_texture
SO ./path_to_the_south_texture
WE ./path_to_the_west_texture
EA ./path_to_the_east_texture
F 220,100,0
C 225,30,0

        111111111
       11000000011
      1100000000011
      1000000000001
      1000000000001
      1000000000001
      1111111111111
      1000000000001
      1000000000001
      1000000000001
      1000000000001
      1000000000001
      1000000000001
      1000000000001
      1000000000001
      1000000000001
      1000000000001
      1000000000001
      1000000000001
      1000000000001
      1000000000001
      1000000000001
      1000000000001
      1000000000001
      100000S000001
      1000000000001
      1000000000001
      1000000000001
      1000000000001
      1000000000001
      1000000001111
      1000000000011
      1000000001111
      1000111100001
11111110001  100001111111
10000000001  100000000001
10000000001  100000000001
10000000001  100000000001
10000000001  100000000001
10000000001  100000000001
10000000001  100000000001
11111111111  111111111111
