NO assets/textures/eagle.xpm
SO assets/textures/redbrick.xpm
WE assets/textures/wood.xpm
EA assets/textures/purplestone.xpm
F 34,34,34
C 170,170,255

111111
100001
10N001
101101
101001
111111
