NO ./path_to_the_north_texture
SO ./path_to_the_south_texture
WE ./path_to_the_west_texture
EA ./path_to_the_east_texture
F 220,100,0
C 225,30,0

11111111111111111111111111111
101101010101010101010101101
10001000100010001000100010001
10101010001010100010101010101
10000000100000001000000000001
101010100000000010101010101
10101010100010001010101010101
10101010100000001010101010101
10000000000000000000000000001
100000001000N0001000000000001
10000000000000000000000000001
10101010100000001010101010101
10101010100010001010101010101
101010100000000010101010101
10000000100000001000000000001
10101010101010101010101010101
10001000000010000000100010001
101101010101010101010101101
11111111111111110111011111111
